///##-#/#------------
/#/##-#/#------------
/#/##-#/#----#-------
/#/##-#/##-----------
/#/##-#/##-----------
/#/##-#/###----------
/#/##-#/#------------
/#/##-#/#------------
/#/##-#/#------------
/####-#/#----#-------
/#----#/#------------
/######/#------------
////////#---#--------
#########------------
---#---------##------
---------------------
-##----##----####----
---------------------
