/////-#-/////-#-/////-
/---/-#-/---/-#-/---/-
/-#-/-#-/-#-/-#-/-#-/-
/-#-/-#-/-#-/-#-/-#-/-
/-#-/-#-/-#-/-#-/-#-/-
/-#-/-#-/-#-/-#-/-#-/-
/-#-/-#-/-#-/-#-/-#-/-
/-#-/-#-/-#-/-#-/-#-/-
/-#-/-#-/-#-/-#-/-#-/-
/-#-/-#-/-#-/-#-/-#-/-
/-#-/-#-/-#-/-#-/-#-/-
/-#-/-#-/-#-/-#-/-#-/-
/-#-/-#-/-#-/-#-/-#-/-
/-#-/-#-/-#-/-#-/-#-/-
/-#-/-#-/-#-/-#-/-#-/-
/-#-/-#-/-#-/-#-/-#-/-
/-#-/-#-/-#-/-#-/-#-/-
/-#-/-#-/-#-/-#-/-#-/-
/-#-/-#-/-#-/-#-/-#-/-
/-#-/-#-/-#-/-#-/-#-/-
/-#-/---/-#-/---/-#-/-
/-#-/////-#-/////-#-//
