/-#-/////-#-/////-#-/
/-#-/---/-#-/---/-#-/
/-#-/-#-/-#-/-#-/-#-/
/-#-/-#-/-#-/-#-/-#-/
/-#-/-#-/-#-/-#-/-#-/
/-#-/-#-/-#-/-#-/-#-/
/-#-/-#-/-#-/-#-/-#-/
/-#-/-#-/-#-/-#-/-#-/
/-#-/-#-/-#-/-#-/-#-/
/-#-/-#-/-#-/-#-/-#-/
/-#-/-#-/-#-/-#-/-#-/
/-#-/-#-/-#-/-#-/-#-/
/-#-/-#-/-#-/-#-/-#-/
/-#-/-#-/-#-/-#-/-#-/
/-#-/-#-/-#-/-#-/-#-/
/-#-/-#-/-#-/-#-/-#-/
/---/-#-/---/-#-/---/
/////-#-/////-#-/////
