---------------/-----
---------------/-----
#---/////---////-----
----///#/////--------
----//////-----------
---///////#----------
--///--///-----------
--///--////----------
--///-##///----------
---//////----#-------
---//-//-------------
---//#---------------
---//-------#--------
---//----------------
---///-------##------
---///---------------
-##//--##----####----
---///---------------
