-----/---------------
-----/---------------
#----/-------#-------
-----/---------------
-----/---------------
-----/----#----------
-----/---------------
-----/---------------
-----/##-------------
-----//------#-------
---#--/--------------
----##/--------------
------/-----#--------
------/--------------
---#--/------##------
------//-------------
-##----/#----####----
-------/-------------
