---------/-----
---------/-----
---------/-----
---------/-----
---------/-----
---------/-----
---------/-----
---------/-----
---------/-----
---------/-----
---------/-----
---------/-----
/------///-----
////////-------
---------------
