----///--------------
---//-//-------------
#--/---//----#-------
---/--##//-----------
---//----//----------
----/#----//---------
----//-----//--------
-----/--/---//-------
-----/##//---//------
--////---/---#//-----
--/#-----/-----//----
--//##---/------/----
---/-----/--#---//---
---//----/-------/---
---#///--/---##--/---
------////-------/---
-##----##----####/---
-----------------//--
