.................#########.....############################.....
...######.......#---------#...#----------------------------#....
..#------#.....#-----------#.#------------------------------#...
.#--------#....#-----------#.#-///////////////////////////---#..
#----------#...#-----------#.#-/-----------------------------##.
#----------#...#-/////////-#.#-/-----------------------------###
#-////////-#...#-/-------/-#.#-/-###############################
#-/------/-#...#-/--...--/-#.#-/-###############################
#-/------/-#...#-/--...--/-#.#-/-----------------------------###
#-/--..--/-#...#-/--...--/-#.#-/-----------------------------###
#-/--..--/-#...#-/--...--/-#.#-///////////////////////////---###
#-/--..--/-#...#-/--...--/-#.#---------------------------/---###
#-/--..--/-#...#-/--...--/-#..##########################-/---###
#-/--..--/-#...#-/--...--/-#...........................#-/---###
#-/--..--/-#...#-/--...--/-#..##########################-/---###
#-/--..--/-#...#-/--...--/-#.#---------------------------/---###
#-/--..--/--###--/--...--/-#.#-///////////////////////////---###
#-/--..--/-------/--...--/-#.#-/-----------------------------###
#-/--..--/////////--...--/-#.#-/-###############################
#-/--..-------------...--/-#.#-/-###############################
#-/--..-###########-...--/-#.#-/------------------------------##
#-/--..-###########-...--/-#.#-////////////////////////////----#
#-/--..-#----------------/-#.#----------------------------/----#
#-/--..-#-////////////////-#.#----------------------------/----#
#-/-----#-/----------------#..##########################--/----#
#-/-----#-/----------------#...........................#--/----#
#-/////-#-/--###############...........................#--/----#
#-----/-#-/--###################################.......#--/----#
.#----/-#-/------------------------------------#.......#--/----#
..#---/-#-/------------------------------------#.......#--/----#
...#--/-#-/----//////////////////////////////--#.......#--/----#
....#-/-#-/----/----------------------------/--#.......#--/----#
....#-/-#-/----/-----------################-/--#.......#--/----#
....#-/-#-/----/--#######-#...............#-/--#.......#--/----#
....#-/-#-/----/--#.....#-#...............#-/--#.......#--/----#
....#-/-#-/----/--#.....#-#...............#-/--#.......#--/----#
....#-/-#-/----/--#.....#--#############..#-/--#.......#--/----#
....#-/-#-/----/--#.....#--------------#..#-/--#.......#--/----#
....#-/-#-/----/--#.....#--///////////-#..#-/--#.......#--/----#
....#-/-#-/----/--#.....#--/---------/-#..#-/--#.......#--/----#
....#-/-#-/----/--#.....#--/---------/-#..#-/--#.......#--/----#
....#-/-#-/----/--#.....#--/---###---/-#..#-/--#.......#--/----#
....#-/-#-/----/--#.....#--/---###---/-#..#-/--#.......#--/----#
....#-/-#-/----/--#.....#--/---###---/-#..#-/--#.......#--/----#
....#-/-#-/----/--#.....#--/---###---/-#..#-/--#.......#--/----#
....#-/-#-/----/--#.....#--/---###---/-#..#-/--#.......#--/----#
....#-/-#-/----/--#.....#--/---###---/-#..#-/--#.......#--/----#
....#-/-#-/----/--#.....#--/---###---/-#..#-/--#.......#--/----#
....#-/-#-/----/--#.....#--/---###---/-#..#-/--#.......#--/----#
....#-/-#-/----/--#.....#--/---###---/-#..#-/--#.......#--/----#
....#-/-#-/----/--#.....#--/---###---/-#..#-/--#.......#--/----#
....#-/-#-/----/--#.....#--/---###---/-#..#-/--#.......#--/----#
....#-/-#-/----/--#.....#--/---###---/-#..#-/--#.......#--/----#
....#-/-#-/----/--#.....#--/---###---/-#..#-/--#.......#--/----#
....#-/-#-/----/--#.....#--/---###---/-#..#-/--#.......#--/----#
....#-/-#-/----/--#.....#--/---###---/-#..#-/--#.......#--/----#
....#-/-#-/----/--#.....#--/---###---/-#..#-/--#.......#--/----#
....#-/-#-/----/--#######--/---###---/-#..#-/--#.......#--/----#
....#-/-#-/----/-----------/---###---/-#..#-/---#######---/----#
....#-/-#-/----/-----------/---###---/-#..#-/-------------/----#
....#-/-#-/----/////////////---------/-#..#-/-------------/----#
....#-/-#-/--------------------------/-#..#-/-------------/----#
....#---#-////////////////////////////-#..#-///////////////----#
....####################################..######################
