---------------------
---------------------
#------------#-------
------##-------------
---------------------
-----#----#----------
---------------------
---------------------
------##-------------
-------------#-------
---#-----------------
----##---------------
------------#--------
---------------------
---#---------##------
---------------------
-##----##----####----
---------------------