......------------......
.....--------------.....
....-////////////---....
...-//----------/----...
..-//-#-----#---//----..
.--/--#-----#----////--.
--//--#-----#-------/---
--/---#-----#--///--/---
--/-----------//-/--//--
--/-///-///////--/---/--
--/-/-///--------/---/--
--/-/----##-----//---/--
--/-//--##-----//----/--
--/--//------///-----/--
--/---/----///------//--
--/////-////------///---
-----#----------#-/-----
-----#----------#-/-----
.-----##########--/----.
..----------------/---..
...-------------///--...
....------------/---....
.....------//////--.....
......-----/------......
